00303003300|
21111111120|
13030030010|
10211112313|
13103012010|
10211111123|
13033003300