33333000000|
11123333333|
03312111111|
21121330330|
13031300000|
21112300000|
33033300000