333333333300000000|
111111111300000000|
333333331300000000|
000000031300000000|
000000031300000000|
000000031300000000|
000000031300000000|
000000031333333333|
000000031111111111|
000000033333333333|
000000000000000000