33333330000|
11111230000|
33333130000|
00003130000|
00003133333|
00003211111|
00003333333